22222222222222222222222222222222222222222222222222222222
25555555555555555555555555522555555555555555555555555552
25555555555555555555555555522555555555555555555555555552
25505050505050505050505050522550505050505050505050505052
25555555555555555555555555522555555555555555555555555552
25505222222550522222222550555550522222222550522222255052
25555255552555525555552555555555525555552555525555255552
25505255552550525555552550505050525555552550525555255052
25555222222555522222222555555555522222222555522222255552
25505555555550555555555550522550555555555550555555555052
25555555555555555555555555522555555555555555555555555552
25505050505050505050505050522550505050505050505050505052
25555555555555555555555555522555555555555555555555555552
25505222222550522550522222222222222550522550522222255052
25555222222555522555522222222222222555522555522222255552
25505555555550522550555555522555555550522550555555555052
25555555555555522555555555522555555555522555555555555552
25505050505050522550505050522550505050522550505050505052
25555555555555522555555555522555555555522555555555555552
22222550522550522222222550522550522222222550522550522222
22222555522555522222222555522555522222222555522555522222
25555550522550555555555550555550555555555550522550555552
25555555522555555555555555555555555555555555522555555552
25505050522550505050505050505050505050505050522550505052
25555555522555555555555555555555555555555555522555555552
25505222222550522550522223333332222550522550522222255052
25555222222555522555523333333333332555522555522222255552
25505555555550522550523333333333332550522550555555555052
25555555555555522555523333333333332555522555555555555552
25505050505050522550523333333333332550522550505050505052
25555555555555522555523333333333332555522555555555555552
25505222222550522550523333333333332550522550522222255052
25555222222555522555522222222222222555522555522222255552
25505555522550522550555555555555555550522550522555555052
25555555522555522555555555555555555555522555522555555552
25505050522550522550505050505050505050522550522550505052
25555555522555522555555555555555555555522555522555555552
22222550522550522550522222222222222550522550522550522222
22222555522555522555522222222222222555522555522555522222
25555550555550555550555555555555555550555550555550555552
25555555555555555555555555555555555555555555555555555552
25505050505050505050505050505050505050505050505050505052
25555555555555555555555555555555555555555555555555555552
25505222222550522222222550522550522222222550522222255052
25555222222555522222222555522555522222222555522222255552
25505555522550555555555550522550555555555550522555555052
25555555522555555555555555522555555555555555522555555552
25505050522550505050505050522550505050505050522550505052
25555555522555555555555555522555555555555555522555555552
22222550522550522550522222222222222550522550522550522222
22222555522555522555522222222222222555522555522555522222
25555550555550522550555555522555555550522550555550555552
25555555555555522555555555522555555555522555555555555552
25505050505050522550505050522550505050522550505050505052
25555555555555522555555555522555555555522555555555555552
25505222222550522222222550522550522222222550522222255052
25555222222555522222222555522555522222222555522222255552
25505555555550555555555550555550555555555550555555555052
25555555555555555555555555555555555555555555555555555552
25505050505050505050505050505050505050505050505050505052
25555555555555555555555555555555555555555555555555555552
22222222222222222222222222222222222222222222222222222222
55555555555555555555555555555555555555555555555555555555
55555555555555555555555555555555555555555555555555555555
